0000000000000000000
0000000000000000000
0000000000000000000
0000000000000000000
0000000000000044400
0000004444444043400
0000004222224042400
0044444244424442400
0042222240422222400
0044444440444444400
0000000000000000000
0000000000000000000
0000000000000000000
0000000000000000000
0000000000000000000
3 8