66666666666666666666666666666666666666
66666666666666666666666666666666666666
00000000000000000000000000000000000000
00000000000000000000000000000000000000
00000000000000000000000000000000000000
00000000000000000000000000000444440000
00000000000000000000000000000452240000
00000000000000000000000000000423540000
00000000000000000000000000000422540000
00000000000000000000000000000425240000
00000000000000000000000000000455240000
00000000000000000000000000000425240000
00000000000000000000000000000422240000
00004444444444444444444444444422240000
00004222522255225222522252222252240000
00004244444444444444444444444444440000
00004540000000000000000000000000000000
00004244440000000000000000000000000000
00004222240000000000000000000000000000
00004444440000000000000000000000000000
00000000000000000000000000000000000000
00000000000000000000000000000000000000
00000000000000000000000000000000000000
00000000000000000000000000000000000000
00000000000000000000000000000000000000
00000000000000000000000000000000000000
00000000000000000000000000000000000000
00000000000000000000000000000000000000
00000000000000000000000000000000000000
00000000000000000000000000000000000000
8 18
