66666666666666666666666666666666666666
66666666666666666666666666666666666666
00000000000000000000000000000000000000
00000000000000000000000000000000000000
00000000000000000000000000000000000000
00000000000000000000000000000000000000
00000000000000000000000000000000000000
00000000000000000000000000000000000000
00000000000000000000000000000000000000
00000444444444444444444444444444000000
00000432252225522252222525252224000000
00000444444444444444444444444424000000
00000000000000000000000000000454000000
00000044444444444444444444444424000000
00000045222225222522225522222224000000
00000042444444444444444444444444000000
00000045400000000000000000000000000000
00000042444444444444444444440000000000
00000042222522225222252222240000000000
00000044444444444444444444540000000000
00000000000000000000000004240000000000
00000000000000000000000004240000000000
00000000000000000000000004240000000000
00000000000000000000000004440000000000
00000000000000000000000000000000000000
00000000000000000000000000000000000000
00000000000000000000000000000000000000
00000000000000000000000000000000000000
00000000000000000000000000000000000000
00000000000000000000000000000000000000
26 22