66666666666666666666666666666666666666
66666666666666666666666666666666666666
00000000000000000000000000000000000000
00000000000000000000000000000000000000
00000000000000000000000000000000000000
00000000000000000000000000000000000000
00000000000000000000000000000000000000
00000000000000000000000000000000000000
00000444444444444444444444444444400000
00000422225222522225222255222222400000
00000422552225222552222222255222400000
00000425444444444444444444444452400000
00000422400000000000000000000422400000
00000422400000000000000000000425400000
00000452400444444444444444400422400000
00000452400425225222225522400452400000
00000452400422255253222252400425400000
00000422400444422222222444400422400000
00000422400000422225222400000422400000
00000455400000422522252400000452400000
00000422400000422222252400000422400000
00000422444444452222222444444422400000
00000425222222222552222225222252400000
00000422225225552222525222552552400000
00000444444444444444444444444444400000
00000000000000000000000000000000000000
00000000000000000000000000000000000000
00000000000000000000000000000000000000
00000000000000000000000000000000000000
00000000000000000000000000000000000000
31 9