66666666666666666666666666666666666666
66666666666666666666666666666666666666
00000000000000000000000000000000000000
00000000000000000000000000000000000000
00000000000000000000000000000000000000
00000000000000000000000000000000000000
00000000000000000000000000000000000000
00000000444444444400000444444444400000
00000000455522252400000422225522400000
00000000422222522400000425522252400000
00000000422552252400000422222222400000
00000000422222252444444422252222400000
00000000042225552222222222252224000000
00000000004222222244244222222240000000
00000000000422252242224222222400000000
00000000000425222222322225222400000000
00000000000425222242224222222400000000
00000000004222222244244225222240000000
00000000042222222552225225222524000000
00000000422225222444444422222222400000
00000000422222222400000422255222400000
00000000425522552400000422255222400000
00000000422255222400000422222222400000
00000000444444444400000444444444400000
00000000000000000000000000000000000000
00000000000000000000000000000000000000
00000000000000000000000000000000000000
00000000000000000000000000000000000000
00000000000000000000000000000000000000
00000000000000000000000000000000000000
9 22