00000000000000000000000000000000000000
00000000000000000000000000000000000000
00000000000000000000000000000000000000
00000000000000000000000000000000000000
00000000000000000000000000000000000000
00000000000000000000000000000000000000
00000000000000000000000000000000000000
00000000000000000000000000000000044400
00000000000000000000000000000000043400
00000000000000000000000000000000042400
00000000000000000000000000000000045400
00000000000000000000000000444444442400
00000000000000000000000000422252252400
00000000000000000000000000452444444400
00000000000000000000000000425400000000
00444444444444444444444444422400000000
00422525222552222522222522252400000000
00422222522522522252222522522400000000
00444444444444444444444444444400000000
00000000000000000000000000000000000000
00000000000000000000000000000000000000
00000000000000000000000000000000000000
00000000000000000000000000000000000000
00000000000000000000000000000000000000
00000000000000000000000000000000000000
00000000000000000000000000000000000000
00000000000000000000000000000000000000
00000000000000000000000000000000000000
00000000000000000000000000000000000000
00000000000000000000000000000000000000
3 17