66666666666666666666666666666666666666
66666666666666666666666666666666666666
00000000000000000000000000000000000000
00000000000000000000000000000000000000
00000000000000000000000000000000000000
00000000000000000000000000000000000000
00000000000000000000000000000000000000
00000000000000000000000000000000000000
00000000000000004444400000000000000000
00000000000000004522400000000000000000
00000000000000004522400000000000000000
00000000000000004252400000000000000000
00000000000000004252400000000000000000
00004444444444444522444444444444440000
00004522222225522525225222222225240000
00004222252255222522222552225222240000
00004322255252222222225252225555240000
00004444444444444444444444444444440000
00000000000000000000000000000000000000
00000000000000000000000000000000000000
00000000000000000000000000000000000000
00000000000000000000000000000000000000
00000000000000000000000000000000000000
00000000000000000000000000000000000000
00000000000000000000000000000000000000
00000000000000000000000000000000000000
00000000000000000000000000000000000000
00000000000000000000000000000000000000
00000000000000000000000000000000000000
00000000000000000000000000000000000000
32 14