66666666666666666666666666666666666666
66666666666666666666666666666666666666
00000000000000000000000000000000000000
00000000000000000000000000000000000000
00004444444444440000000000000000000000
00004552225222540000000000000000000000
00004552225222240000000000000000000000
00004444455252240000000000000000000000
00000000422222540000000000000000000000
00000000422252244444444440000000000000
00004444422532252252252240000000000000
00004555225225544444444240000000000000
00004552222222240000004240000000000000
00004252444452240000004240000000000000
00004552400422240000004240000000000000
00004222444425240000004240000000000000
00004222222522240000004544444444400000
00004225222552240000004252222252400000
00004444444444440000004444444442400000
00000000000000000000000000000045400000
00000000000000000000000000000042400000
00000000000000000000000000000042400000
00000000000000000000000000000045400000
00000000000000000000000000000042400000
00000000000000000000000000000042400000
00000000000000000000000000000042400000
00000000000000000000000000000044400000
00000000000000000000000000000000000000
00000000000000000000000000000000000000
00000000000000000000000000000000000000
31 25