66666666666666666666666666666666666666
66666666666666666666666666666666666666
00000000000000000000000000000000000000
00000000000000000000000000000000000000
00000000000000000000000000000000000000
00000000000000000000000000000000000000
00000000000000000000000000000000000000
00000000000000000000000000000000000000
00000000000000000000000000000000000000
00000000000000000000000000000000000000
00000000004444400044444000000000000000
00000000004222444442224000000000000000
00000000004242442442424000000000000000
00000000004225225225224444000000000000
00000000004442442442444434000000000000
00000000000442442442444424400000000000
00000000000422225225224422400000000000
00000000000422242442424222400000000000
00000000000422222442224244400000000000
00000000000424444444444222400000000000
00000000000422222222222222400000000000
00000000000444444444444444400000000000
00000000000000000000000000000000000000
00000000000000000000000000000000000000
00000000000000000000000000000000000000
00000000000000000000000000000000000000
00000000000000000000000000000000000000
00000000000000000000000000000000000000
00000000000000000000000000000000000000
00000000000000000000000000000000000000
16 12 
