00000000000000000000000000000000000000
00000000000000000000000000000000000000
00444444444444444444444444444444444400
00422222222222222222222222222222222400
00422222222222222222222222222222222400
00422222222222222222222222222222222400
00422222222522222222222222222222222400
00422222222222222222225222222222222400
00422222222222222222222222222222222400
00422222222222222222222222222222222400
00422222222522222222222222222222222400
00422222222222222222225222222222222400
00422222222222222222222222222222222400
00422252222522222222222222222222222400
00422222222222222222222222222222222400
00422222222222222222222222222222222400
00422222222222222222222222222222222400
00422222222222222222222222222222222400
00422222222222222222222222222222222400
00422222222222222222222222222222222400
00422222222522222222222222222222222400
00422222222222222222222222222222222400
00422222222222222252222225222222222400
00422222222222222222222222222222222400
00422222222222222222252222222222222400
00422222522222222222222222222222222400
00422222222222222222222522222252222400
00444444444444444444444444444444444400
00000000000000000000000000000000000000
00000000000000000000000000000000000000
15 8