0000000000000000000
0444444444444444440
0422222222222222240
0422222222222222240
0422222222222222240
0422222222222222240
0422222222222222240
0422222222222222240
0422222222222222240
0422222222222222240
0422222222222222240
0422222222222222240
0422222222222222240
0444444444444444440
0000000000000000000
15 8