66666666666666666666666666666666666666
66666666666666666666666666666666666666
00000000000000000000000000000000000000
00000000000000000000000000000000000000
00000000000000000000000000000000000000
00000000000000000000000000000000000000
00000000000000000000000000000000000000
00000000000000000000000000000000000000
00000000000000000000000044400000000000
00000000000000000000000043400000000000
00000000000000000000004442444000000000
00000000000044444444444525254000000000
00000000000042222222244542454000000000
00000000000042224444224225224000000000
00000000000042222524224442444000000000
00000000000444524224225242444000000000
00000000000422544424442442444000000000
00000000000424222422222425554000000000
00000000000424242454222424454000000000
00000000000422542454222422454000000000
00000000000444225524222444454000000000
00000000000004224224225555554000000000
00000000000004444444444444444000000000
00000000000000000000000000000000000000
00000000000000000000000000000000000000
00000000000000000000000000000000000000
00000000000000000000000000000000000000
00000000000000000000000000000000000000
00000000000000000000000000000000000000
00000000000000000000000000000000000000
25 19 
