66666666666666666666666666666666666666
66666666666666666666666666666666666666
00000000000000000000000000000000000000
00000000000000000000000000000000000000
00000000000000000000000000000000000000
00000000000000000000000000000000000000
00000000000000000000000000000000000000
00000000000000000000000000000000000000
00000000000000000444404440000000000000
00000000000044444422444240000000000000
00000000000042242225225540000000000000
00000000000042222222442240000000000000
00000000000042444222222244000000000000
00000000000042424444455524000000000000
00000000000045222222252244000000000000
00000000000042424422255540000000000000
00000000004442424222222540000000000000
00000000004242424222255540000000000000
00000000004542424444452444440000000000
00000000004542524322254422240000000000
00000000004544544444422252240000000000
00000000004555540000444444440000000000
00000000004444440000000000000000000000
00000000000000000000000000000000000000
00000000000000000000000000000000000000
00000000000000000000000000000000000000
00000000000000000000000000000000000000
00000000000000000000000000000000000000
00000000000000000000000000000000000000
00000000000000000000000000000000000000
24 19
