66666666666666666666666666666666666666
66666666666666666666666666666666666666
00000000000000000000000000000000000000
00000000000000000000000000000000000000
00000000000000000000000000000000000000
00000000000000000000000000000000000000
00000000000000000000000000000000000000
00000000000000000000000000000000000000
00000000000000000000000000000000000000
00000000000000000000000000000000000000
00000000000044444444444444440000000000
00000000000442222222222222240000000000
00000000000422444455222252240000000000
00000000000422252222222252240000000000
00000000000444254442444424440000000000
00000000000004254443422424000000000000
00000000000444254444422424000000000000
00000000000422222444422424000000000000
00000000000424442222222444000000000000
00000000000424442222242400000000000000
00000000000422222444222400000000000000
00000000000444444404444400000000000000
00000000000000000000000000000000000000
00000000000000000000000000000000000000
00000000000000000000000000000000000000
00000000000000000000000000000000000000
00000000000000000000000000000000000000
00000000000000000000000000000000000000
00000000000000000000000000000000000000
00000000000000000000000000000000000000
24 17
