66666666666666666666666666666666666666
66666666666666666666666666666666666666
00000000000000000000000000000000000000
00000000000000000000000000000000000000
00000000000000000000000000000000000000
00000444444444444444444444444444400000
00000422522255225242224222242522400000
00000444444222222242224222244422400000
00000422524222425242224442242252400000
00000422224252422242252252242222400000
00000422444444422242222552242222400000
00000422224252222552244444442522400000
00000425522225522222222552222242400000
00000444444442252252222222442242400000
00000425432422224444444225525222400000
00000422422222522422252222222522400000
00000452444444444422222422242222400000
00000422424222422222222442242222400000
00000422224222222222252222242222400000
00000422222222555552242225244444400000
00000422222224222222242225222252400000
00000444422224222422245522222252400000
00000422222224222225242225522222400000
00000444444444222522242222444444400000
00000452555252224222225522224222400000
00000452224222224222242225222522400000
00000444444444444444444444444444400000
00000000000000000000000000000000000000
00000000000000000000000000000000000000
00000000000000000000000000000000000000
31 25