66666666666666666666666666666666666666
66666666666666666666666666666666666666
00000000000000000000000000000000000000
00000000000000000000000000000000000000
00000000000000000000000000000000000000
00000000000000000000000000000000000000
00000000000000000000000000000000000000
00000000000004444444444400000000000000
00000000000045252535252540000000000000
00000000000452544444445254000000000000
00000000000425400000004524000000000000
00000000000452400000004254000000000000
00000000000425400000004524000000000000
00000000000452400000004254000000000000
00000000000425400000004524000000000000
00000000000452444444444254000000000000
00000000000425252525252524000000000000
00000000000452525252525254000000000000
00000000000425444444444524000000000000
00000000000452400000004254000000000000
00000000000425400000004524000000000000
00000000000444400000004444000000000000
00000000000000000000000000000000000000
00000000000000000000000000000000000000
00000000000000000000000000000000000000
00000000000000000000000000000000000000
00000000000000000000000000000000000000
00000000000000000000000000000000000000
00000000000000000000000000000000000000
00000000000000000000000000000000000000
18 16