66666666666666666666666666666666666666
66666666666666666666666666666666666666
00000000000000000000000000000000000000
00000000000000000000000000000000000000
00000000000000000000000000000000000000
00000000000000000000000000000000000000
00000000000000000000000000000000000000
00000000000000000000000000000000000000
00000000000000004444044444400000000000
00000000000000004224442242400000000000
00000000000000004252225242400000000000
00000000000000044424442442440000000000
00000000004444442254442225240000000000
00000000004224442424242442440000000000
00000000004252225252545225400000000000
00000000004252222424242442400000000000
00000000004255455252525242444000000000
00000000004255422424242442224000000000
00000000004255442252525244424000000000
00000000004255442244242243224000000000
00000000004255244444444444444000000000
00000000004222240000000000000000000000
00000000004444440000000000000000000000
00000000000000000000000000000000000000
00000000000000000000000000000000000000
00000000000000000000000000000000000000
00000000000000000000000000000000000000
00000000000000000000000000000000000000
00000000000000000000000000000000000000
00000000000000000000000000000000000000
25 9
